0400022000
0100000000
0411400000
0001110000
0225110020
0021450000
0005110020
0411400200
0100022000
0411114000