0400022000
0100000000
0411400000
0000100000
0220100020
0020400000
0000100020
0411400200
0100022000
0411114000